1111111111111111111111111111111111111111
1111111111111111111111111111111110000111
11111100000000011111111111100001100E0111
1111110000000001100000000010000010000111
1100000000000000000000000010000000000111
1100000000000000000000000000000000000111
1000000000000000000000000000000000000111
1000000000000000000000000000000000000011
1000000001110000000000000000000111000011
1000000001110000000000000000000111000011
1000000000010000000000000000000111000011
1000000000010000000000000000000110000011
1000000000010000100000000000000110000001
1000000000000000100000000000000110000001
1000000000000000111100000000000010000001
1000000000000000111100000000000000000001
10000000000000001111000000000000000C0001
1000000000000000001100000011100000000001
1100000000000000001100000011111110000011
1100P00000000000000100000011111110000111
1111111100000000000000011111111111111111
1111111100000000000000011111111111111111
1111111111111111111111111111111111111111