1111111111111111
10010000000C0C01
1000000000000001
1000011111001001
1000011111001001
10001100000010C1
1P0011E0000010C1
1111111111111111